WWWWWWWWWWWWWWW
WP  B BBB BBBBW
W W W W W W W W
W    Y    B B W
WBW R W W WBW W
W       R  B  W
W W     W W W W
WB   B   B   RW
WBW W W WBW W W
W    YBB   B BW
W WBW W W W W W
W  Y     B   GW
WWWWWWWWWWWWWWW